ko: không
k: không
hong: không
thik: thích
vl: vãi
vãi lò: vãi
lol: cười lớn
cú: cứu
mjh: mình
penalty: phạt đền
thắng pen: thắng phạt đền
befood: ứng dụng giao hàng công nghệ
a.c: ác
siu: siêu
uki: đồng ý
“nóc nhà”: vợ, người yêu
ae: anh em
gánh: làm nhiều việc thay phần người khác
còng lưng: phải làm nhiều, mệt mỏi
t: tao 
khoải: khỏi cần
sóp pi: ứng dụng Shopee
tkeo zõi: theo dõi
buổi off: buổi họp mặt
hâm: khùng
điiiii: đi
cmt: comment
ảo ma canada: phi thực tế
phết: nhiều
cháy nhất: hấp dẫn nhất
đồng bọn: bạn bè chơi chung
m.áu me: máu me
gi.ật gân: giật gân
gh.ê rợn: ghê rợn
cạ cứng: bạn thân
share: chia sẻ
gen z: những người sinh từ năm 1999 trở đi
crush: người mình thích thầm
đê: đi
săn deal: săn các khuyến mãi
onl: online
keo: đẹp
check var: kiểm tra độ chân thật
2k7: 2007
healing: chữa lành
pạn: bạn
mng: mọi người
mn: mọi người
mụi người: mọi người
hỉu nhằm: hiểu nhầm
vn: Việt Nam
quậy đục nước:  quậy hết cỡ
oánh: đánh
hints: gợi ý
liềng: liền
elm: em
nhìu: nhiều
stt: status
nấu xói: nói xấu
bảnh: cách xưng hô ngôi thứ nhất
stk: số tài khoản
sì gòn: Sài Gòn
hum naiiiiii: hôm nay
mem: thành viên
ngòn khon: ngon
cấu bò: có bầu
pé: bé
chuỷn tìn: chuyển tiền
ck: chồng
z : vậy
mí: mấy
t.ự t.ử: tự tử
t.ự. s.á.t: tự sát
tiu-đây: người thứ ba trong mối quan hệ
cây cà lem: chồng chị 
g/i/ậ/t: giật
c.ư.ớ.p.: cướp
đ.u.ổ.i: đuổi
m,a,i t,h,u,ý: ma tuý
ét ô ét: SOS
ce: chị em
lậ.u: lậu
tym: tim
zai: trai
mắc ẻ: mắc đi vệ sinh
tam tai: xui xẻo
ao chình: quá giỏi
bửn: bẩn
th: thôi
zua: vua
đc: được 
khum: không
pùn: buồn
g/i/ế/t: giết
choicaitrogimatday: chơi cái trò gì mất dạy
éo: không
e: em
khét: đỉnh
/á/c ứ/ớ/p: xác ướp
êi: ê
hông: không
t/a/i n/ạ/n: tai nạn
mài: mày
ae: anh em
dzà: già
hé lo: xin chào
toi: tôi
từn: tuần
bik: biết
chiện: chuyện
dzữ: dữ
choá: chó
kê: ok
tìn iu: tình yêu
tình iêu: tình yêu
tau: tao
gòy: rồi
thèng: thằng
đếy: đấy
dừa: vừa
chớt: chết
hok: không
zị: vậy
đệp: đẹp
méo: không
bùn: buồn
mak: mà
thank ciu: thank you
j: gì
cíu: cứu
z: vậy
valungtung: valentine
cúi từn: cuối tuần 
tr: trời
ní: bạn
dỡn: giỡn
oai phai: wifi
đê: đi
pạn: bạn
pà: bà
okê: ok
r: rồi
mơn: cảm ơn
chại: chạy
gu gồ: google
xiền: tiền
vs: với
hông đa: hãng xe honda
h: giờ
cty: công ty
gkê: ghê
dzô: vô
iu: yêu
cít: phân
lớp du tu dờ mun: love you to the moon
đ.ấ.m: đấm
suxvat: súc vật 
dà: già
kănk: căng
wa’: quá
sa.le: giảm giá
kăng: căng
boiz: boy
embe: em bé
q.u.a đ.ờ.i: qua đời
t.a.i n.ạ.n: tai nạn
kon: con
xink: xinh
yang lake: giang hồ
cà thơi: con gái yêu con gái
k.h.ỏ.a t.h.â.n: khoả thân 
vk: vợ
mkt: maketing
zan: gian
hã: hả
v: vậy
i: đi
síp ber: người giao hàng
quó: quá
sicula: chocolate
sờ-trét: stress
seo: sao
guộc:  lâu năm
trôn: troll
qua' da~: quá đã
ad: admin
culi: người lao động phải làm nhiều việc
btc: ban tổ chức
pkê pka: phê pha
múc bang: truyền hình ăn uống
onl: online
oto: ô tô
ngo: ngu
shao: sao
goyy: rồi
sg: sài gòn
quài: hoài
bbi: em bé
ák độk: ác độc
xốp: shop
bnh: bao nhiêu
ngừ: người
ak: á
thí: thấy
fb: facebook
nhiu: nhiêu
phổn lòng: phỏng vãi
noái: nói
gồi: rồi
quèn chá nà: không sao hết
moà: mà
lém: lắm
chuỵ: chị
chớt: chết
hớt: hết
í: ấy
zẻ: vẻ
fan: người hâm mộ
nyc: người yêu cũ
ny: người yêu
chăn cù: chăn cừu
bu ca sao: bao cao su
qhtd: quan hệ tình dục
âu: đâu
tóp tóp: tiktok
qqjz: quần què gì vậy
bla bla: vâng vâng
tiểu tam: người thứ ba
ròi: rồi
ngầu đét: nhìn thật ngầu, sang chảnh
khok: khóc
sub: subscribe
diu túp: youtube
ng ta: người ta
pình: bình
hoàng hun: hoàng hôn
zậy: vậy 
tks: thanks
chiên daaa: chuyên gia
đéy: đấy
fb: facebook
móa: má
co vít: covid
fa: người ế
xin lõi: xin lỗi
ulatroi: u là trời
nhụt: nhục
adidaphat: a di đà phật
vjppro: đỉnh quá
vjp: đỉnh
chung bìn: trung bình
so sắc: sâu sắc
baạ: bạn
tin đờ: tinder
lào: nào
xkld: xuất khẩu lao động
ai đồ: idol
ngta: người ta
hi-five: đập tay
ziên: viên

 



















